0000000000000000000000000000300000000000
0000000000000000000000022222200000000000
0000000000000000000000000000000000000000
0000000000000000000000000000000000000000
0000000000000000000000000000000000000000
0000000000000000022222200000000000000000
0000000000000000000000000000000000000000
0000000000000000000000000000000000000000
0000000000000000000000000000000000000000
0000000000000000000000022222000000000000
0000000000000000000000000000000000000000
0000000000000000000000000000000000000000
0000000000000000022222000000000000000000
0000000000000000000000000000000000000000
0000000000000000000000000000000000000000
0000000000000000000000002222200000000000
0000000000000000000000000000000000000000
0000000000000000022222000000000000000000
0000000000000000000000000000000000000000
0000000000000000000000000000000000000000
0000000000000000000002222200000000000000
0000002222200000000000000000002220000000
0000000000000000000000000002221112000000
0000200000002000000000000000000000000022
2222100000000200000000000000000222200022
1111100000000122000000000000002111122222
1111100000000111222200000000021111111120
1111100000000111111122222222211111111110
1111100000000111111111111111111111111110