00000000000000000000000000000000000000
00000000000000000000000000000000000000
00000000000000000111111000000000000000
00000000000000000111111000000000000000
00000001111100000000000000000000000000
00000000000000000000000000000000000000
11000000000000000110000001100000000000
11111111111111111110000111110001111111
11111111111111111110000111110001100011
11111111111111111110000011000000000000
11111111111111111110000010000000000000
11111111111111111110000010000000000000
11111111111111111110000000000000000000