00000000000000000000000000000000000000000000000000000000000000000000000000000000000000000000000000000000000300
00000000000000000000000000000000000000000000000000000000000000000000000000000000000000000000000000000022222220
00000000000000000000000000000000000000000000000002000220000200000000000000000000000000000000000000000000000000
00000000000000000000022222200222202222020000020020200202000200000000000000000000000000000002000000000000000000
00000000000000000000000020000200002000002000200020200200200200000000000000000000000000000002222220000000000000
00000000000000000000000020000222202222000202000222220200020200000000000000000000000000000000000022200000000000
00000000000000000000002020000200002000000222000200020200002200000000000000000000000000000000000000200000000000
00000000000000000000002220000222202222000020000200020200000200000000000000000000000000000000000000000000000222
00000000000000000000000000000000000000000000000000000000000000000000000000000000000000000000000000000002222000
00000000000000000000000000000000000000000000000000000000000000000000000000000000000000000000000000000000000000
00000000000000000000000000000000000000000000000000000000000000000000000000000000000000000000000000000000000000
00000000000000000000000000000000000000000000000000000000000000000000000000000000000000000002220000000000000000
00000000000000000000000000000000000000000000000000000000000000000000000000000000000000000000022220000000000000
00000000000000000000000000222222222222222222222222222222222200000000000000000000000000000000000000000000000000
00000000000000000000000002200000000000000000000000000000002000000000000000000000000000000000000000000000022200
00000000000000000000000000000000000000000000000000000000020000000000000000000000000000000000000000000022220000
00000000000000000000022222220000000000000000000000000000200000000000000000000000000000000000000000000000000000
00000000000000000000000000000000000000000000000000000002000000000000000000000000000000000000222222000000000000
00000000000000000000000000000000000000000000000000000022200000000000000000000000000000000000000000000000000000
00000000000000002222222000000000000000000000000000000000000000000000000000000000000000000000000000000000000000
00000000000000000000000000000000000000000000000000000000000000000000000000000000000000000000000002222222200000
00000000000000000000000000000000000000000000000000000000000000000000000000000000000000000000000000000000000000
00000000000022222200000000000000000000000000000000000000000000000000000000000000000000000000000000000000000000
00000000000000000000000000000000000000000000000000000000000000000000000000000000000000000000222222000000000000
00000000000000000000000000000000000000000000000000000000000000000000000000000000000000000000000000000000000000
00000000222222200000000000000000000000000000000000000000000000000000000000000000000000000000000000000000000000
00000022000000000000000000000000000000000000000000000000000000000000000000000000000000222222000000000000000000
00000000000000000000000000000000000000000000000000000000000000000000000000000000000000000000000000000000000000
22222220000000000000000000000000000000000000000000000000000000000000000000000000000002000000000000000000000000
00000002220000000000000000000000000000000000000000000000000000000000000000000000000022222000000000000000000000
00000000022220000000000000000000000000000000000000000000000000000000000000000222222222220000000000000000000000
00000000000002200000000000000000000000000000000000000000000000000000000000022222220000000000000000000000000000
00000000000000022220000000000000000000000000000000000000000000000000000002222222000000000000000000000000000000
00000000000000000022222222220000000000000000000000000000000000000000000222222200000000000000000000000000000000
00000000000000000000000000222200000000000000000000000000000000000000002220000000000000000000000000000000000000
00000000000000000000000000002222000000000000000000000000000000000022222200000000000000000000000000000000000000
00000000000000000000000000000000222222000000000000000000000000002222222200000000000000000000000000000000000000
00000000000000000000000000000000000002222000000000000000000000002222200000000000000000000000000000000000000000
00000000000000000000000000000000000000002220000000000000000002222000000000000000000000000000000000000000000000
00000000000000000000000000000000000000000022222222000000000022200000000000000000000000000000000000000000000000
00000000000000000000000000000000000000000000000002222222222222000000000000000000000000000000000000000000000000
00000000000000000000000000000000000000000000000000000220222222000000000000000000000000000000000000000000000000
00000000000000000000000000000000000000000000000000000000222020000000000000000000000000000000000000000000000000